NAME test
TAGS is_entry
MAP
  ##############      
  #............#      
  #.....*......#      
  #............#      
  #..@..##.....#      
  #.....##.....#      
  #.......d....#      
  #............#      
  #............#      
  ########.#####      
         #.#          
         #.#          
   #######.#          
   #.......#          
   #.#######          
   #.#                
   #.#################
   #.................#
   #.................#
   #................##
   #...............## 
   #..............##  
   ################   
ENDMAP
